Mm, Mm, Mm, Mm, Mm, Mm, Gs^Fp, Gs^Fp, Mm, Mm, Mm, Mm, Gg, Hh, Hh, Gg, Hh, Hh, Hh, Gg, Gg, Gg, Gg, Gg, Gg, Gs^Fp, Gg, Gg, Gg, Gs^Fp, Gs^Fp, Gg, Gg, Gg, Gg, Ww, Ww
Mm, Mm, Mm, Mm, Mm, Mm, Gs^Fp, Gs^Fp, Mm, Mm, Mm, Mm, Gg, Hh, Hh, Gg, Hh, Hh, Hh, Gg, Gg, Gg, Gg^Efm, Gg, Gg^Efm, Gg, Gg, Gg, Gs^Vhr, Gs^Fp, Gs^Fp, Gg, Gg, Gg, Gg, Ww, Ww
Mm, Mm, Mm, Mm, Mm, Mm, Hh, Mm, Mm, Mm, Mm, Mm, Hh, Hh, Hh, Hh^Vhhr, Re^Gvs, Gg, Gg, Gg, Gg, Gg, Gg, Gg, Gg, Gg, Gg, Gg, Gg, Gs^Fp, Gs^Fp, Gg, Gg, Gg, Ww, Ww, Ww
Mm, Mm, Mm, Hh, Mm, Mm, Mm, Mm, Mm, Mm, Gs^Fp, Hh, Hh, Hh, Gg, Re^Gvs, Re^Gvs, Re^Gvs, Re^Gvs, Gg, Gg, Gg, Gg, Gg, Gg, Gg, Gg, Gg, Gg, Gs^Fp, Gg, Gg, Ww, Ww, Ww, Ww, Ww
Mm, Mm, Mm, Mm, Mm, Mm, Mm, Mm, Mm, Gs^Fp, Gs^Fms, Hh^Vhhr, Gs^Fp, Hh, Gg, Re^Gvs, Re^Gvs, Re^Gvs, Gg, Gg, Gg, Gg^Efm, Gg, Gg, Gg, Gg, Gg, Gg, Ww, Gg, Ww, Ww, Ww, Ww, Gg, Gg^Efm, Gg^Efm
Mm, Mm, Mm, Mm, Hh, Mm, Gg, Mm, Gg^Fetd, Hh, Gg, Hh, Gs^Fms, Gs^Fp, Gs^Fms, Gg, Gg, Gg, Gg, Gg, Gg, Gg, Gg, Gg, Gg, Gg, Ww^Bw\, Ww, Ww, Ww, Ww, Ww, Gg, Gg^Efm, Gg, Gg, Gg
Mm, Mm, Mm, Mm, Gg, Gg, Gg, Gs^Fms, Gs^Fds, Gg, Gg, Gs^Fds, Gs^Fds, Gg, Gs^Fds, Gs^Fds, Gg, Gg, Gg, Gg, Gg, Gg, Gg, Gg, Ww, Ww, Ww, Ww^Bw\r, Gg, Gg, Gg, Gg, Gg, Gg, Gg^Fetd, Gs^Fms, Gs^Fms
Mm, Mm, Mm, Mm, Gg^Fetd, Gg, Gg, Gs^Fms, Gs^Fds, Gs^Fds, Gs^Fds, Gs^Fds, Gs^Fds, Gs^Fds, Gs^Fds, Gg^Fetd, Gg, Gg, Ww, Ww, Ww, Ww, Ww, Ww, Ww, Ww, Gg, Gg, Gg, Gg, Gg, Gg, Gs^Fds, Gg, Gs^Fds, Gs^Fms, Gs^Fms
Mm, Mm, Mm, Gs^Fp, Mm, Gg, Hh, Gg, Gg, Gg, Gs^Fds, Gg^Fetd, Gs^Fds, Gs^Fds, Gg, Gg, Ww, Ww, Ww, Ww, Gg, Ww, Gg, Ww, Gg, Gs^Fds, Gg, Gg, Gg, Gg, Gs^Fds, Gg, Gg, Gg, Gs^Fds, Gg, Gg
Mm, Mm, Mm, Mm, Mm, Mm, Hh, Hh, Gs^Fp, Gg, Gs^Fds, Gs^Fds, Gs^Fds, Gg, Gg^Vhr, Ww, Ww, Ww, Gg, Gg, Gs^Fds, Gs^Fds, Gg, Gg, Gg, Gg, Re^Gvs, Gg^Vhr, Re^Gvs, Re^Gvs, Gg, Gg, Gg, Gg, Gs^Fms, Gs^Fms, Gs^Fp
Mm, Mm, Mm, Mm, Mm, Mm, Gg, Gg, Gg, Gs^Fms, Gs^Fms, Gg, Gs^Fms, Gg, Gg, Ww, Ww, Gg, Gs^Fds, Gg^Fetd, Gs^Fds, Gg^Ve, Gg, Gg, Re^Gvs, Re^Gvs, Re^Gvs, Re^Gvs, Re^Gvs, Re^Gvs, Gg, Gg^Fetd, Gg, Gs^Fds, Gg, Gs^Fms, Gs^Fds
Mm, Mm, Mm, Mm, Mm, Mm, Mm, Gg, Gs^Fp, Gs^Fms, Gg, Gs^Fms, Gg, Gg, Gg, Ww, Ww^Bw/r, Gg, Gg, Gs^Fds, Re, Gg, Gg, Gg, Gg, Re^Gvs, Re^Gvs, Re^Gvs, Re^Gvs, Re^Gvs, Gg, Gg, Gg, Gg, Gs^Fms, Gs^Fms, Gs^Fds
Gg, Gg, Gg, Mm, Mm, Mm, Mm, Hh^Vhhr, Hh, Gg, Gg, Gg, Gg^Efm, Gg, Gg, Ww^Bw/r, Ww, Gg, Gg, Gg, Gg, Gg, Gs^Fds, Gg, Gg, Gg^Efm, Gg, Re^Gvs, Gg, Gg, Gg, Gg, Gg, Gs^Fds, Gg, Gs^Fds, Gs^Fds
Mm, Mm, Mm, Gg, Mm, Mm, Mm, Gg, Gg, Gg, Gg^Efm, Gg, Re, Gg, Ww, Ww, Gg, Ww, Ww, Gg, Gg, Gg, Gg, Gg, Gg^Efm, Gg, Gg, Gg, Gg, Gg, Re^Gvs, Gg, Gg, Gg, Gg, Gs^Fds, Gs^Fp
Mm, Mm, Mm, Hh, Gg, Mm, Mm, Mm, Gg, Gg, Gg^Efm, Re, Re^Gvs, Re^Gvs, Ww, Gg, Gg, Gg, Gg, Ww, Gg, Gg, Gg^Efm, Gg, Gg, Gg^Efm, Gg, Gg, Re^Gvs, Re^Gvs, Re^Gvs, Re^Gvs, Re^Gvs, Gg^Ve, Gs^Fms, Gs^Fds, Gs^Fms
Mm, Mm, Mm, Mm, 3 Mm, Gg, Gs^Fds, Gg, Gg, Gg, Gg, Gg, Re^Gvs, Re^Gvs, Gg, Ww, Gg, Gg^Vhr, Gg, Ww, Gg, Gg, Gg, Gg^Efm, Gg, Gg^Efm, Gg, Gg, Re^Gvs, Re^Gvs, Gg, Re^Gvs, Gg, Gs^Fms, Gg, Gs^Fms, Gs^Fms
Mm, Mm, Mm, Hh, Chr, Gg, Chr, Gg, Gg^Fetd, Gg^Efm, Gg, Gg, Gg, Re^Gvs, Ww, Ww, Gg, Gs^Fds, Ww, Ww, Gg, Gg, Gg, Gg, Gg^Ve, Gg, Gg, Gg, Gg, Gg, Gg, Gs^Fds, Gg, Gg, Hh, Gg, Gg
Mm, Mm, Mm, Gg, Chr, Khr, Gg^Fetd, Gg, Gg, Gg, Gg^Efm, Gg, Gg, Gg, Ww, Gg, Gs^Fds, Gg, Ww, Gg, Gg, Gg, Gs^Fds, Hh, Hh, Hh, Hh, Gg, Gg, Gg, Gg, Gg, Gg, Gg, Hh, Gs^Fp, Gs^Fp
Mm, Mm, Mm, Gg, Gs^Fds, Chr, Chr, Gs^Fds, Gg, Re, Gg, Gg, Gg^Vhr, Gg, Ww, Gg, Ww, Ww, Gg, Gg^Vhr, Gg, Gs^Fds, Hh, Hh, Hh, Gs^Fp, Hh, Gg, Gg, Gg, Gg, Gg, Gg, Gg, Gs^Fp, Gs^Fp, Gs^Fp
Mm, Mm, Mm, Mm, Hh, Gs^Fds, Gg, Gg, Gg, Gg, Gg, Gg, Ww^Bw\, Ww, Ww, Ww, Gg, Gg, Gg^Efm, Gg, Gg, Hh, Gs^Fms, Hh, Gg^Ve, Hh, Gg, Gg, Gg, Gg, Gg, Gg, Gg, Hh, Hh, Hh, Hh
Mm, Mm, Mm, Mm, Hh, Gg, Gg, Gg, Gg, Gg, Ww, Ww, Ww, Ww^Bw\, Gg, Gg, Gs^Fds, Gg, Gg^Efm, Gg, Gg, Gg, Gs^Fms, Gs^Fms, Gs^Fp, Gs^Fp, Gg, Gg, Re^Gvs, Hh, Gg, Gg, Gg, Gg^Fetd, Gg, Gs^Fp, Gs^Fp
Mm, Mm, Mm, Hh, Hh, Hh^Vhhr, Gg, Gg, Gg, Ww, Ww, Ww, Gg, Gg, Gg, Gg, Gg, Gg, Gg, Gs^Fms, Gs^Fp, Gg, Gg, Gs^Fp, Gg, Gs^Fp, Gg, Re^Gvs, Re^Gvs, Re^Gvs, Gg, Gg, Gg, Gg, Gs^Fp, Gg, Gg
Mm, Mm, Mm, Mm, Hh, Hh, Hh, Gg, Ww, Ww, Ww, Gg, Gs^Fds, Gg, Gs^Fms, Gs^Fds, Gs^Fms, Gg, Gs^Fds, Re, Re, Gg, Gg, Gg, Gg, Gg, Gg, Re^Gvs, Re^Gvs, Re^Gvs, Gg, Gg, Gg, Gg, Gg, Gg, Gg
Mm, Mm, Mm, Mm, Gs^Fp, Hh, Hh, Hh, Ww, Ww, Gg, Gg, Gs^Fms, Gg^Fetd, Gs^Fds, Gs^Fms, Gs^Fp, Gg, Gs^Fms, Gs^Fms, Gs^Fp, Gg, Gg, Gg, Gs^Fp, Gs^Fp, Gs^Fp, Re^Gvs, Gg, Gg, Gg, Gg, Gg, Hh, Gg, Hh, Hh
Mm^Xm, Mm, Mm, Mm, Gs^Fp, Gs^Fp, Ww, Ww, Hh, Gg, Gs^Fp, Gs^Fms, Hh, Gs^Fms, Hh, Gg^Ve, Gs^Fp, Gs^Fp, Gs^Fms, Gs^Fms, Gs^Fp, Gs^Fp, Gg, Gg, Gs^Fp, Gs^Fp, Gs^Fp, Gg^Ve, Gg, Gg, Gg, Gg, Gg, Gg, Gg, Gg, Gg
Xu, Mm^Xm, Xu, Mm, Ww, Ww, Hh, Hh, Hh, Gs^Fp, Gg^Fetd, Gs^Fp, Gs^Fp, Hh, Hh, Gs^Fp, Gs^Fp, Gs^Fp, Gs^Fp, Gs^Fp, Gs^Fp, Gg, Gs^Fp, Re, Gs^Fp, Gs^Fp, Gs^Fp, Gs^Fp, Gs^Fp, Gg, Gg, Gg, Gg, Gg, Gg, Gg, Gg
Xu, Xu, Uu, Uu, Ww, Hh, Mm, Hh, Hh, Gs^Fp, Gs^Fp, Gs^Fp, Gg, Hh, Gs^Fp, Gg^Fetd, Gs^Fp, Gs^Fp, Gg, Gs^Fp, Gs^Fp, Gs^Fp, Gg, Gg, Gs^Fp, Gs^Fp, Gs^Fp, Gs^Fp, Gs^Fp, Gs^Fp, Gg, Gg, 2 Gg, 1 Gg, Gg, Gg, Gg
Xu, Uu, Ww, Ww, Xu, Mm, Mm, Mm, Hh, Hh, Hh, Gs^Fp, Gs^Fp, Gg^Ve, Gs^Fp, Gs^Fp, Gs^Fp, Gs^Fp, Gs^Fp, Gs^Fp, Gs^Fp, Gs^Fp, Gg, Gs^Fp, Gs^Fp, Gs^Fp, Gs^Fp, Gg, Gg, Gg, Gg, Gg, Gg, Gg, Gg, Gs^Fp, Gs^Fp
Uu, Uu, Ww, Xu, Xu, Mm^Xm, Mm^Xm, Mm, Mm, Hh, Hh, Gs^Fp, Gs^Fp, Gg, Gs^Fp, Gs^Fp, Gs^Fp, Gs^Fp, Gs^Fp, Gs^Fp, Gs^Fp, Gs^Fp, Gg, Gs^Fp, Gs^Fp, Gs^Fp, Gs^Fp, Gg, Gg, Gg, Gg, Gg, Gg, Gg, Gg, Gs^Fp, Gs^Fp
