Mm, Mm, Mm, Mm, Mm, Mm, Gs^Fp, Gs^Fp, Mm, Mm, Mm, Mm, Gg, Hh, Hh, Gg, Hh, Hh, Hh, Gg, Gg, Gg, Gg, Gg, Gg, Gs^Fp, Gg, Gg, Gg, Gs^Fp, Gs^Fp, Gg, Gg, Gg, Gg, Ww, Wo
Mm, Mm, Mm, Mm, Mm, Mm, Gs^Fp, Gs^Fp, Mm, Mm, Mm, Mm, Gg, Hh, Hh, Gg, Hh, Hh, Hh, Gg, Gg, Gg, Gg^Efm, Gg, Gg^Efm, Gg, Gg, Gg, Gs^Vhr, Gs^Fp, Gs^Fp, Gg, Gg, Gg, Gg, Ww, Wo
Mm, Mm, Mm, Mm, Mm, Mm, Hh, Mm, Mm, Mm, Mm, Mm, Hh, Hh, Hh, Hh^Vhhr, Re^Gvs, Gg, Gg, Gg, Gg, Gg, Gg, Gg, Gg, Gg, Gg, Gg, Gg, Gs^Fp, Gs^Fp, Gg, Gg, Gg, Ww, Ww, Wo
Mm, Mm, Mm, Hh, Mm, Mm, Mm, Mm, Mm, Mm, Gs^Fp, Hh, Hh, Hh, Gg, Re^Gvs, Re^Gvs, Re^Gvs, Re^Gvs, Gg, Gg, Gg, Gg, Gg, Gg, Gg, Gg, Gg, Gg, Gs^Fp, Gg, Gg, Wo, Wo, Wo, Wo, Wo
Mm, Mm, Mm, Mm, Mm, Mm, Mm, Mm, Mm, Gs^Fp, Gs^Fms, Hh^Vhhr, Gs^Fp, Hh, Gg, Re^Gvs, Re^Gvs, Re^Gvs, Gg, Gg, Gg, Gg^Efm, Gg, Gg, Gg, Gg, Gg, Gg, Ww, Gg, Ww, Ww, Wo, Ww, Gg, Gg^Efm, Gg^Efm
Mm, Mm, Mm, Mm, Hh, Mm, Gg, Mm, Gg^Fetd, Hh, Gg, Hh, Gs^Fms, Gs^Fp, Gs^Fms, Gg, Gg, Gg, Gg, Gg, Gg, Gg, Gg, Gg, Gg, Gg, Ww^Bw\, Ww, Wo, Wo, Wo, Wo, Gg, Gg^Efm, Gg, Gg, Gg
Mm, Mm, Mm, Mm, Gg, Gg, Gg, Gs^Fms, Gs^Fds, Gg, Gg, Gs^Fds, Gs^Fds, Gg, Gs^Fds, Gs^Fds, Gg, Gg, Gg, Gg, Gg, Gg, Gg, Gg, Ww, Ww, Wo, Ww^Bw\r, Gg, Gg, Gg, Gg, Gg, Gg, Gg^Fetd, Gs^Fms, Gs^Fms
Mm, Mm, Mm, Mm, Gg^Fetd, Gg, Gg, Gs^Fms, Gs^Fds, Gs^Fds, Gs^Fds, Gs^Fds, Gs^Fds, Gs^Fds, Gs^Fds, Gg^Fetd, Gg, Gg, Wo, Wo, Wo, Wo, Wo, Ww, Wo, Wo, Gg, Gg, Gg, Gg, Gg, Gg, Gs^Fds, Gg, Gs^Fds, Gs^Fms, Gs^Fms
Mm, Mm, Mm, Gs^Fp, Mm, Gg, Hh, Gg, Gg, Gg, Gs^Fds, Gg^Fetd, Gs^Fds, Gs^Fds, Gg, Gg, Ww, Wo, Ww, Ww, Gg, Ww, Gg, Wo, Gg, Gs^Fds, Gg, Gg, Gg, Gg, Gs^Fds, Gg, Gg, Gg, Gs^Fds, Gg, Gg
Mm, Mm, Mm, Mm, Mm, Mm, Hh, Hh, Gs^Fp, Gg, Gs^Fds, Gs^Fds, Gs^Fds, Gg, Gg^Vhr, Ww, Wo, Wo, Gg, Gg, Gs^Fds, Gs^Fds, Gg, Gg, Gg, Gg, Re^Gvs, Gg^Vhr, Re^Gvs, Re^Gvs, Gg, Gg, Gg, Gg, Gs^Fms, Gs^Fms, Gs^Fp
Mm, Mm, Mm, Mm, Mm, Mm, Gg, Gg, Gg, Gs^Fms, Gs^Fms, Gg, Gs^Fms, Gg, Gg, Ww, Wo, Gg, Gs^Fds, Gg^Fetd, Gs^Fds, Gg^Ve, Gg, Gg, Re^Gvs, Re^Gvs, Re^Gvs, Re^Gvs, Re^Gvs, Re^Gvs, Gg, Gg^Fetd, Gg, Gs^Fds, Gg, Gs^Fms, Gs^Fds
Mm, Mm, Mm, Mm, Mm, Mm, Mm, Gg, Gs^Fp, Gs^Fms, Gg, Gs^Fms, Gg, Gg, Gg, Ww, Ww^Bw/r, Gg, Gg, Gs^Fds, Re, Gg, Gg, Gg, Gg, Re^Gvs, Re^Gvs, Re^Gvs, Re^Gvs, Re^Gvs, Gg, Gg, Gg, Gg, Gs^Fms, Gs^Fms, Gs^Fds
Gg, Gg, Gg, Mm, Mm, Mm, Mm, Hh^Vhhr, Hh, Gg, Gg, Gg, Gg^Efm, Gg, Gg, Ww^Bw/r, Wo, Gg, Gg, Gg, Gg, Gg, Gs^Fds, Gg, Gg, Gg^Efm, Gg, Re^Gvs, Gg, Gg, Gg, Gg, Gg, Gs^Fds, Gg, Gs^Fds, Gs^Fds
Mm, Mm, Mm, Gg, Mm, Mm, Mm, Gg, Gg, Gg, Gg^Efm, Gg, Re, Gg, Wo, Wo, Gg, Wo, Wo, Gg, Gg, Gg, Gg, Gg, Gg^Efm, Gg, Gg, Gg, Gg, Gg, Re^Gvs, Gg, Gg, Gg, Gg, Gs^Fds, Gs^Fp
Mm, Mm, Mm, Hh, Gg, Mm, Mm, Mm, Gg, Gg, Gg^Efm, Re, Re^Gvs, Re^Gvs, Wo, Gg, Gg, Gg, Gg, Wo, Gg, Gg, Gg^Efm, Gg, Gg, Gg^Efm, Gg, Gg, Re^Gvs, Re^Gvs, Re^Gvs, Re^Gvs, Re^Gvs, Gg^Ve, Gs^Fms, Gs^Fds, Gs^Fms
Mm, Mm, Mm, Mm, 3 Mm, Gg, Gs^Fds, Gg, Gg, Gg, Gg, Gg, Re^Gvs, Re^Gvs, Gg, Wo, Gg, Gg^Vhr, Gg, Wo, Gg, Gg, Gg, Gg^Efm, Gg, Gg^Efm, Gg, Gg, Re^Gvs, Re^Gvs, Gg, Re^Gvs, Gg, Gs^Fms, Gg, Gs^Fms, Gs^Fms
Mm, Mm, Mm, Hh, Chr, Gg, Chr, Gg, Gg^Fetd, Gg^Efm, Gg, Gg, Gg, Re^Gvs, Wo, Wo, Gg, Gs^Fds, Wo, Wo, Gg, Gg, Gg, Gg, Gg^Ve, Gg, Gg, Gg, Gg, Gg, Gg, Gs^Fds, Gg, Gg, Hh, Gg, Gg
Mm, Mm, Mm, Gg, Chr, Khr, Gg^Fetd, Gg, Gg, Gg, Gg^Efm, Gg, Gg, Gg, Wo, Gg, Gs^Fds, Gg, Wo, Gg, Gg, Gg, Gs^Fds, Hh, Hh, Hh, Hh, Gg, Gg, Gg, Gg, Gg, Gg, Gg, Hh, Gs^Fp, Gs^Fp
Mm, Mm, Mm, Gg, Gs^Fds, Chr, Chr, Gs^Fds, Gg, Re, Gg, Gg, Gg^Vhr, Gg, Wo, Gg, Wo, Wo, Gg, Gg^Vhr, Gg, Gs^Fds, Hh, Hh, Hh, Gs^Fp, Hh, Gg, Gg, Gg, Gg, Gg, Gg, Gg, Gs^Fp, Gs^Fp, Gs^Fp
Mm, Mm, Mm, Mm, Hh, Gs^Fds, Gg, Gg, Gg, Gg, Gg, Gg, Ww^Bw\, Ww, Wo, Wo, Gg, Gg, Gg^Efm, Gg, Gg, Hh, Gs^Fms, Hh, Gg^Ve, Hh, Gg, Gg, Gg, Gg, Gg, Gg, Gg, Hh, Hh, Hh, Hh
Mm, Mm, Mm, Mm, Hh, Gg, Gg, Gg, Gg, Gg, Wo, Ww, Wo, Ww^Bw\, Gg, Gg, Gs^Fds, Gg, Gg^Efm, Gg, Gg, Gg, Gs^Fms, Gs^Fms, Gs^Fp, Gs^Fp, Gg, Gg, Re^Gvs, Hh, Gg, Gg, Gg, Gg^Fetd, Gg, Gs^Fp, Gs^Fp
Mm, Mm, Mm, Hh, Hh, Hh^Vhhr, Gg, Gg, Gg, Wo, Ww, Wo, Gg, Gg, Gg, Gg, Gg, Gg, Gg, Gs^Fms, Gs^Fp, Gg, Gg, Gs^Fp, Gg, Gs^Fp, Gg, Re^Gvs, Re^Gvs, Re^Gvs, Gg, Gg, Gg, Gg, Gs^Fp, Gg, Gg
Mm, Mm, Mm, Mm, Hh, Hh, Hh, Gg, Ww, Wo, Ww, Gg, Gs^Fds, Gg, Gs^Fms, Gs^Fds, Gs^Fms, Gg, Gs^Fds, Re, Re, Gg, Gg, Gg, Gg, Gg, Gg, Re^Gvs, Re^Gvs, Re^Gvs, Gg, Gg, Gg, Gg, Gg, Gg, Gg
Mm, Mm, Mm, Mm, Gs^Fp, Hh, Hh, Hh, Wo, Wo, Gg, Gg, Gs^Fms, Gg^Fetd, Gs^Fds, Gs^Fms, Gs^Fp, Gg, Gs^Fms, Gs^Fms, Gs^Fp, Gg, Gg, Gg, Gs^Fp, Gs^Fp, Gs^Fp, Re^Gvs, Gg, Gg, Gg, Gg, Gg, Hh, Gg, Hh, Hh
Mm^Xm, Mm, Mm, Mm, Gs^Fp, Gs^Fp, Wo, Wo, Hh, Gg, Gs^Fp, Gs^Fms, Hh, Gs^Fms, Hh, Gg^Ve, Gs^Fp, Gs^Fp, Gs^Fms, Gs^Fms, Gs^Fp, Gs^Fp, Gg, Gg, Gs^Fp, Gs^Fp, Gs^Fp, Gg^Ve, Gg, Gg, Gg, Gg, Gg, Gg, Gg, Gg, Gg
Xu, Mm^Xm, Xu, Mm, Wo, Wo, Hh, Hh, Hh, Gs^Fp, Gg^Fetd, Gs^Fp, Gs^Fp, Hh, Hh, Gs^Fp, Gs^Fp, Gs^Fp, Gs^Fp, Gs^Fp, Gs^Fp, Gg, Gs^Fp, Re, Gs^Fp, Gs^Fp, Gs^Fp, Gs^Fp, Gs^Fp, Gg, Gg, Gg, Gg, Gg, Gg, Gg, Gg
Xu, Xu, Xu, Xu, Wo, Hh, Mm, Hh, Hh, Gs^Fp, Gs^Fp, Gs^Fp, Gg, Hh, Gs^Fp, Gg^Fetd, Gs^Fp, Gs^Fp, Gg, Gs^Fp, Gs^Fp, Gs^Fp, Gg, Gg, Gs^Fp, Gs^Fp, Gs^Fp, Gs^Fp, Gs^Fp, Gs^Fp, Gg, Gg, 2 Gg, 1 Gg, Gg, Gg, Gg
Xu, Xu, Wo, Wo, Xu, Mm, Mm, Mm, Hh, Hh, Hh, Gs^Fp, Gs^Fp, Gg^Ve, Gs^Fp, Gs^Fp, Gs^Fp, Gs^Fp, Gs^Fp, Gs^Fp, Gs^Fp, Gs^Fp, Gg, Gs^Fp, Gs^Fp, Gs^Fp, Gs^Fp, Gg, Gg, Gg, Gg, Gg, Gg, Gg, Gg, Gs^Fp, Gs^Fp
Xu, Xu, Wo, Xu, Xu, Mm^Xm, Mm^Xm, Mm, Mm, Hh, Hh, Gs^Fp, Gs^Fp, Gg, Gs^Fp, Gs^Fp, Gs^Fp, Gs^Fp, Gs^Fp, Gs^Fp, Gs^Fp, Gs^Fp, Gg, Gs^Fp, Gs^Fp, Gs^Fp, Gs^Fp, Gg, Gg, Gg, Gg, Gg, Gg, Gg, Gg, Gs^Fp, Gs^Fp
