Mm, Mm, Xu, Mm, Xu, Xu, Xu, Mm, Mm, Mm, Mm, Mm, Mm, Mm, Mm, Mm, Mm, Mm, Mm, Mm, Mm, Mm, Mm, Mm, Mm
Mm, Xu, Kte, Xu, Uu^Vu, Uh, Uu^Vu, Xu, Mm, Mm, Mm, Mm, Mm, Mm, Hhd, Mm, Hh^Vo, Mm, Mm, Mm, Mm, Mm, Mm, Mm, Mm
Mm, Xu, Kte, Qxu, Uh, Uu, Uu, Xu, Mm, Mm, Gg, Gg, Gg, Hhd, Hhd, Hhd, Mm, Mm, Gg, Mm, Mm, Mm, 1 Mm, Mm, Rd
Mm, Xu, Xu, Qxu, Xu, Uu, Hh^Fp, Xu, Mm, Mm, Rd, Gg^Es, Gg, Hhd, Rd, Mm, Mm, Mm, Rd, Mm, Mm, Mm, Rd, Rd, Mm
Mm, Mm, Mm, Xu, Mm, Mm, Hh^Fp, Hh^Fmw, Rd, Rd, Mm, Gg, Mm, Rd, Hh, Rd, Rd, Rd, Mm, Rd, Rd, Rd, Mm, 2 Mm, Mm
Mm, Mm, Mm, Mm, Mm, Hh^Fmw, Hh^Fp, Rd, Mm, Mm, Mm, Mm, Mm, Hh, Mm, Mm, Mm, Hhd, Mm, Mm, Hh, Hh, Hh, Mm, Mm
Mm, Mm, Mm, Mm, Mm, Hh^Fp, Hh^Fp, Rd, Mm, Mm, Mm, Mm, Hh, Mm, Mm, Mm, Mm, Hhd, Hh, Hh, Mm, Hh, Mm, Hh, Mm
Mm, Mm, Mm, Mm, Mm, Mm, Mm, Rd, Rd, Mm, Hh, Hh^Vo, Mm, Hh, Mm, Mm, Mm, Hh^Vo, Mm, Mm, Mm, Mm, Mm, Mm, Mm
Mm, Mm, Mm, Mm, Mm, Mm, Mm, Mm, Hh, Rd, Hh, Mm, Mm, Mm, Mm, Mm, Mm, Mm, Mm, Mm, Mm, Mm, Mm, Mm, Mm
Mm, Mm, Mm, Mm, Mm, Mm, Mm, Mm, Mm, Rd, Hhd, Hhd, Hhd, Mm, Mm, Mm, Mm, Mm, Mm, Mm, Mm, Mm, Mm, Mm, Wo
Ww, Mm, Mm, Mm, Mm, Mm, Mm, Mm, Mm, Hh, Hh, Rd, Rd, Gg, Gg, Mm, Mm, Mm, Mm, Mm, Mm, Mm, Wo, Wo, Mm
Mm, Ww, Ww, Mm, Mm, Mm, Mm, Mm, Mm, Hh^Vo, Mm, Mm, Rd, Gg, Mm, Mm, Mm, Mm, Hh^Fds, Mm, Mm, Mm, Wo, Mm, Mm
Mm, Mm, Mm, Ww, Ww, Mm, Mm, Mm, Hh^Fp, Mm, Mm, Mm, Rd, Mm, Mm, Mm, Mm, Hh^Fp, Hh^Fp, Mm, Wo, Wo, Mm, Mm, Mm
Mm, Mm, Mm, Mm, Mm, Ww, Mm, Mm, Hh^Fmw, Hh^Fds, Gs^Fet, Gll^Fp, Rd, Mm, Mm, Mm, Hh^Vo, Hh^Fp, Wo, Wo, Mm, Mm, Mm, Mm, Mm
Mm, Mm, Mm, Mm, Mm, Ww, Ww, Mm, Mm, Hh, Hh, Hh, Rd, Mm, Ww, Mm, Ww, Ww, Wo, Mm, Mm, Mm, Mm, Mm, Mm
Mm, Mm, Mm, Mm, Mm, Mm, Ss, Ww, Ww, Mm, Wwf, Rd, Ww, Ww, Wo, Ww, Wo, Wo, Mm, Mm, Mm, Mm, Mm, Mm, Mm
Mm, Mm, Xu, Mm, Ss, Ss, Ss, Hhd, Mm, Ww, Wwf, Ww^Es, Ww, Wo, Wo, Wo, Ww, Ww, Ww, Mm, Mm, Mm, Mm^Vo, Mm, Mm
Xu, Xu, Uu, Xu, Xu, Xu, Uu, Mm, Hhd, Hhd, Wwf, Ww^Es, Ww^Es, Ww, Ww, Ww, Mm, Mm, Mm, Mm, Mm, Mm, Mm, Mm, Mm
Xu, Xu, Xuc, Xu, Uu^Tf, Uh^Em, Uu^Em, Uu, Xu, Ss, Ss, Wwf, Wwf, Wwf, Ww, Mm, Mm, Mm, Mm, Mm, Mm, Mm, Mm, Mm, Mm
Uu, Ss^Vhs, Uu, Sm, Ss, Uu^Tf, Uu^Tf, Xu, Ss, Ss, Mm, Mm, Mm, Mm, Ww, Rd, Gll^Fp, Mm, Mm, Mm, Mm, Mm, Mm, Mm, Mm
Uu, Ss, Ss, Ss, Ss^Vhs, Uu^Em, Xu, Xu, Mm, Ss, Mm, Mm, Mm, Ww, Mm, Rd, Rd, Gll^Fp, Hh^Fp, Mm, Mm, Mm, Mm, Mm, Mm
Uh, Chs, Chs, Ss, Uu^Tf, Uu^Tf, Xu, Mm, Mm, Mm, Mm, Mm, Ww, Ww, Mm, Mm, Gg^Es, Gg, Hh^Fp, Hh^Fp, Hh^Vo, Mm, Mm, Mm, Mm
Uh, Khs, Chs, Uu^Em, Ss^Vhs, Uu^Em, Xu, Mm, Ww, Ww, Ww, Ww, Mm, Mm, Mm, Mm, Hhd, Hh, Hh, Hh, Mm, Hh^Fp, Mm, Mm, Mm
Uh, Uh, Uu^Em, Ss, Uu^Tf, Xu, Ww, Ww, Mm, Mm, Mm, Mm, Gs^Fp, Hh, Rd, Rd, Mm, Hhd, Mm, Mm, Mm, Mm, Mm, Mm, Mm
Xu, Uh, Ss^Vhs, Uu, Xu, Xu, Ww, Mm, Mm, Mm, Mm, Hh^Fp, Hh, Rd, Gg, Mm, Mm, Mm, Mm, Mm, Mm, Mm, Mm, Mm, Mm
Ww, Xu, Xu, Xu, Ww, Ww, Mm, Mm, Mm, Mm, Hh^Vo, Hh, Hh, Gg, Mm, Mm, Mm, Mm, Mm, Mm, Mm, Mm, Mm, Mm, Mm
Mm, Ww, Ww, Ww, Mm, Mm, Mm, Mm, Mm, Mm, Mm, Mm, Gg, Gg, Hh, Mm, Mm, Mm, Mm, Mm, Mm, Mm, Mm, Mm, Mm
Mm, Mm, Mm, Mm, Mm, Mm, Mm, Mm, Mm, Mm, Gg, Rd, Hh, Hh, Mm, Mm, Mm, Mm, Mm, Mm, Mm, Mm, Mm, Mm, Mm
Mm, Mm, Mm, Mm, Mm, Mm, Mm, Gg^Efm, Gg, Gg^Efm, Rd, Rd, Hh, Hh^Vo, Mm, Mm, Mm, Mm, Xu, Mm, Xu, Mm, Xu, Mm, Mm
Mm, Mm, Mm, Mm, Mm, Mm, Mm, Gg, Mm, Gg, Rd, Hh, Mm, Mm, Mm, Mm, Xu, Xu, Uh, Xu, Uu, Xu, Uh, Xu, Xu
Mm, Mm, Mm, Mm, Mm, Mm, Gg, Gg^Efm, Hh, Rd, Hhd, Hh, Mm, Mm, Xu, Xu, Uu^Vud, Uu^Tf, Uu, Uu, Uu^Vud, Ur, Ur, Uh, Uh
Mm, Mm, Mm, Mm, Mm, Mm, Mm, Mm, Hh, Rd, Hh, Mm, Mm, Mm, Xu, Uh, Uu, Uu, Uh, Ql, Ql, Uh, Ur, Uu, Uu
Mm, Mm, Mm, Mm, Mm, Mm, Gg, Hh, Hh, Rd, Rd, Gg, Gg, Mm, Ur, Uu, Ur, Uu, Uu, Uu, Ql, Uu, Uh, Ur, Ur
Mm, Mm, Mm, Mm, Mm, Mm, Hh^Vo, Hh, Gd^Fmw, Hhd, Gg^Efm, Rd, Rd, Rd, Ur, Ur, Uu^Tf, Ur, Ql^Bs\, Ql, Uu, Uu, Cud, Uh, Uu
Mm, Mm, Mm, Mm, Mm, Mm, Hh^Fp, Gll^Fp, Gd^Fet, Gg, Hh, Gg, Gg, Mm, Xu, Uh, Uh, Uu, Ql, Ur, Ur, Cud, Kud, Cud, Cud
Mm, Mm, Mm, Mm, Mm, Mm, Gll^Fp, Gll^Fp, Gd^Fmw, Gd^Fmw, Gll^Fp, Gll^Fp, Gll^Fp, Mm, Mm, Xu, Uu^Vud, Uu, Uu, Ql, Uu, Cud, Cud, Cud, Cud
Mm, Mm, Mm, Mm, Mm, Gll^Fp, Gd^Fmw, Gll^Fp, Gll^Fp, Gll^Fp, Gd^Fmw, Gll^Fp, Gll^Fp, Mm, Mm, Xu, Xu, Uu, Uu, Ql, Uu, Uu^Vud, Cud, Cud, Xu
Mm, Mm, Mm, Mm, Mm, Gll^Fp, Mm, Gll^Fp, Mm, Gll^Fp, Mm, Gll^Fp, Mm, Mm, Mm, Mm, Mm, Xu, Xu, Uu, Xu, Uu, Xu, Xu, Mm
Mm, Mm, Mm, Mm, Mm, Mm, Mm, Mm, Mm, Mm, Mm, Mm, Mm, Mm, Mm, Mm, Mm, Mm, Mm, Xu, Mm, Xu, Mm, Mm, Mm
