Mm, Mm, Xu, Mm, Xu, Xu, Xu, Mm, Mm, Mm, Mm, Mm, Mm, Mm, Mm, Mm, Mm, Mm, Mm, Mm, Mm, Mm, Mm, Mm, Mm
Mm, Xu, Kte, Xu, Uu, Uu, Uu, Xu, Mm, Mm, Mm, Mm, Mm, Mm, Mm, Mm, Mm, Mm, Mm, Mm, Mm, Mm, Mm, Mm, Mm
Mm, Xu, Kte, Qxu, Uu, Uu, Uu, Xu, Mm, Mm, Mm, Mm, Mm, Mm, Mm, Mm, Mm, Mm, Mm, Mm, Mm, Mm, 1 Mm, Mm, Mm
Mm, Xu, Xu, Qxu, Xu, Uu, Gg, Xu, Gg, Mm, Gg, Mm, Gg, Mm, Mm, Mm, Mm, Mm, Mm, Mm, Mm, Mm, Gg, Gg, Mm
Mm, Mm, Mm, Xu, Gg, Gg, Gg, Gg, Mm, Gg, Mm, Gg, Gg, Gg, Gg, Gg, Gg, Mm, Gg, Gg, Gg, Gg, Mm, 2 Mm, Mm
Mm, Mm, Mm, Mm, Gg, Gg, Mm, Mm, Mm, Mm, Mm, Mm, Mm, Mm, Mm, Mm, Mm, Gg, Mm, Gg, Mm, Mm, Mm, Mm, Mm
Mm, Mm, Mm, Mm, Gg, Mm, Mm, Mm, Mm, Mm, Mm, Mm, Mm, Mm, Mm, Mm, Mm, Mm, Mm, Mm, Mm, Mm, Mm, Mm, Mm
Mm, Mm, Mm, Mm, Gg, Mm, Mm, Mm, Mm, Mm, Mm, Mm, Mm, Mm, Mm, Mm, Mm, Mm, Mm, Mm, Mm, Mm, Mm, Mm, Mm
Mm, Mm, Mm, Mm, Gg, Mm, Mm, Mm, Mm, Mm, Mm, Mm, Mm, Mm, Mm, Mm, Mm, Mm, Xu, Mm, Xu, Mm, Xu, Mm, Mm
Mm, Mm, Mm, Mm, Gg, Mm, Mm, Mm, Mm, Mm, Mm, Mm, Mm, Mm, Xu, Xu, Xu, Xu, Uu, Xu, Uu, Xu, Uu, Xu, Xu
Mm, Mm, Xu, Mm, Mm, Gg, Gg, Mm, Mm, Mm, Mm, Mm, Mm, Mm, Xu, Xu, Uu, Uu, Uu, Uu, Uu, Uu, Uu, Uu, Uu
Xu, Xu, Ss, Xu, Xu, Xu, Uu, Gg, Gg, Mm, Mm, Mm, Mm, Mm, Xu, Uu, Uu, Uu, Uu, Uu, Uu, Uu, Uu, Uu, Uu
Uu, Uu, Ss, Ss, Uu, Uu, Uu, Uu, Xu, Gg, Gg, Mm, Gg, Mm, Gg, Uu, Uu, Uu, Uu, Uu, Uu, Uu, Uu, Uu, Uu
Uu, Ss, Sm, Sm, Ss, Uu, Uu, Xu, Mm, Mm, Gg, Gg, Mm, Gg, Gg, Uu, Uu, Uu, Uu, Uu, Uu, Uu, Uu, Uu, Uu
Uu, Ss, Ss, Ss, Ss, Uu, Xu, Xu, Mm, Mm, Gg, Mm, Mm, Mm, Xu, Uu, Uu, Uu, Uu, Uu, Uu, Uu, Uu, Uu, Uu
Uu, Cud, Cud, Ss, Uu, Uu, Xu, Mm, Mm, Mm, Gg, Mm, Mm, Mm, Mm, Xu, Uu, Uu, Uu, Uu, Uu, Uu, Uu, Uu, Uu
Uu, Kud, Uu, Uu, Uu, Uu, Xu, Mm, Mm, Mm, Gg, Gg, Mm, Mm, Mm, Xu, Xu, Uu, Uu, Uu, Uu, Uu, Uu, Uu, Xu
Uu, Uu, Uu, Uu, Uu, Xu, Mm, Mm, Mm, Mm, Gg, Mm, Mm, Mm, Mm, Mm, Mm, Xu, Xu, Uu, Xu, Uu, Xu, Xu, Mm
Xu, Uu, Uu, Uu, Xu, Xu, Mm, Mm, Mm, Mm, Gg, Mm, Mm, Mm, Mm, Mm, Mm, Mm, Mm, Xu, Mm, Xu, Mm, Mm, Mm
Mm, Xu, Xu, Xu, Mm, Mm, Mm, Mm, Mm, Gg, Gg, Mm, Mm, Mm, Mm, Mm, Mm, Mm, Mm, Mm, Mm, Mm, Mm, Mm, Mm
Mm, Mm, Mm, Mm, Mm, Mm, Mm, Mm, Mm, Gg, Mm, Mm, Mm, Mm, Mm, Mm, Mm, Mm, Mm, Mm, Mm, Mm, Mm, Mm, Mm
