Wo, Wo, Wo, Mm, Mm, Mm, Mm, Mm, Gll^Fp, Gs^Fp, Gll^Fp, Gs^Fp, Gll^Fp, Gg, Re, Gg, Hh, Hh, Mm, Mm, Hh, Mm, Mm, Mm, Mm, Mm, Mm, Hh, Hh, Re, Re, Re, Gg, Mm, Mm, Mm, Mm, Hh, Mm, Hh, Mm, Mm
Wo, Wo, Wo, Mm, Wo, Mm, Mm, Mm, Gll^Fp, Gll^Fp, Gll^Fp, Gll^Fp, Gll^Fp, Re, Rd, Gg, Gg, Hh^Vct, Mm, Mm, Hh, Mm, Hh, Mm, Mm, Mm, Hh^Fp, Hh, Re, Re, Gs, Gs, Gs, Mm, Hh^Vhh, Mm, Mm, Mm, Mm, Hh, Mm, Mm
Wo, Wo, Wo, Wo, Wo, Mm, Mm, Hh, Gll^Em, Gs^Fp, Gll^Fp, Gg^Vct, Gs, Gg, Gg, 2 Rd, Re, Gs, Gs^Fms, Mm, Hh^Vhh, Gg, Gg, Gll^Fp, Gll^Fp, Gs^Fds, Gs^Es, Re, Re, Gg, Gs^Efm, Gs, Gs, Hh, Hh, Hh^Es, Mm, Mm, Hh^Fp, Hh, Hh, Mm
Wo, Wo, Wo, Wo, Wo, Mm, Wwg, Mm, Sm, Sm, Sm, Gg, Gs, 1 Gg, Gg, Gg, Re, Gs^Fms, Gs^Fms, Gg, Gs^Fms, Gg, Re^Fds, Gg, Re, Re, Re, Re, Re, Re, Gg, Gll^Fp, Gs^Fms, Gs^Fds, Gs^Fds, Mm, Mm, Mm, Hh, Hh, Wwg, Hh
Mm, Wo, Wo, Wo, Wo, Mm, Mm, Ss, Sm^Em, Ss, Sm, Gg, Gg^Vct, Gg, Gg, Gg^Vct, Gs^Fms, Re^Fds, Gs^Fds, Gs^Fds, Re^Fds, Re^Fms, Gs^Fds, Re^Es, Re^Es, Wwf, Wwg, Wwg, Re, Re, Gg^Efm, Gll^Fp, Gs^Fms, Gs^Fds, Gg, Gs^Fds, Gg, Gg, Hh, Hh, Wwg, Wwg
Mm, Wo, Wo, Wo, Wo, Wo, Wo, Ss, Ss, Ss, Wwg, Sm, Wwg, Wwg, Wwg, Gs^Fms, Gg, Re, Re, Gs^Fds, Re, Re^Fms, Gs^Fms, Gs^Fms, Wwf, Wwf, Re, Re, Re, Gg^Fet, Gg^Efm, Gs, Gg, Gg, Gg, Gg, Wwg, Gg, Wwg, Wwg, Wwg, Wwg
Mm, Mm, Wwg, Wwg, Wo, Wo, Wo, Wo, Wo, Wwg, Wo, Wo, Wo, Wwg, Wwg, Wwg, Wwg, Gg, Chr, Re, Wwg, Gg, Gg, Gg, Wwg, Wwf, Wwf, Wwf, Wwf, Re, Re, Gs^Efm, Gg, Gs^Fds, Wwf, Wwg, Wwg, Wwg, Wo, Wo, Wo, Wwg
Mm, Mm, Mm, Wwg^Es, Wwg^Es, Wo, Wo, Wo, Wo, Wo, Wo, Wo, Wo, Wo, Wo, Wo, Wo, Chr, Wo, Wo, Wo, Wo, Wo, Wo, Wo, Wo, Wwg, Wwf, Wwf, Wwf, Wwg, Wwg, Wwg, Ww, Wo, Wo, Wo, Wo, Wo, Wo, Wo, Wo
Mm, Mm, Mm, Wwg, Wwg, Wwg, Wo^Bw/, Wo, Wo, Wo, Wo, Wo, Wo, Wo, Wo, Wo, Wo, Wo, Wo, Wo, Wo, Wo, Wo, Wo, Wo, Wo, Wwf, Wwf, Wwg, Wwf, Wwf, Wwg, Wo, Wwg, Wo, Wo, Wo, Wo, Wo, Wo, Wo, Wo
Mm, Mm, Mm, Mm, Re, Re, Gs^Fms, Wo, Wo, Wo, Wo, Wo, Wo, Wo, Wo, Wo, Wo, Wo, Wo, Wo, Wo, Wo, Wo, Wo, Wo, Wwg, Wwf, Wwf, Wwf, Wwf, Wo, Wo, Wo, Wo, Wo, Wo, Wo, Wo, Wo, Wo, Wo, Wo
Mm, Mm, Hh, Gg, Re^Gvs, Gs^Wm, Gs, Wo, Wwg, Wo, Wwg, Wwg, Gg, Wo, Re, Wo, Wo, Wo, Wo, Wo, Wo, Wo, Wo, Wo, Wo, Wwg, Wwf^Es, Wwg, Wwf, Wwf, Wo, Wo, Wo, Wo, Gg, Wo, Wwg, Wo, Wo, Wo, Wo, Ds
Hh, Hh, Gs^Fds, Gg, Re^Gvs, Re^Gvs, Gg, Gg, Wwg, Wwg, Wwg, Gg^Wm, Gg^Gvs, Gg^Fet, Re^Vh, Re^Es, Gg, Wo, Wo, Wo, Wwg, Wo, Wo, Wo, Wwg, Wwf, Wwf, Wwf, Gg^Eff, Re^Eff, Re^Eff, Ww, Ce, Re, Re, Wwg, Re, Wwg, Ds, Ds, Ds, Ds
Hh, Gg, Gg, Re^Gvs, Re^Gvs, Re^Gvs, Ce, Gg, Gg, Wwg, Gg, Wwg, Gg^Gvs, Re^Gvs, Re, Gg^Es, Wwg, Wwg, Wwg, Wwg, Wwg, Wwg, Wwg, Wwg, Gg, Gg^Efm, Gll^Fp, Gll^Fp, Gg, Gg, Re, Re, Ket, Ce, Re^Ecf, Gg, Re, Ds, Gg, Gg, Gll^Fp, Gg
Hh, Hh, Gg^Vh, Re^Es, Gs, Gs, Gg, Ce, Re, Gg, Gg, Gg, Gg^Efm, Re, Gg, Gg, Gs^Fds, Gg, Gg, Wwg, Gg, Wwg, Gg, Gg^Efm, Gg^Efm, Gll^Fp, Gll^Fp, Gll^Fp, Re, Re, Re, Ce, Ce, Ce, Gll^Fp, Gg, Gs^Vl, Gg, Gll^Fp, Gll^Fp, Gll^Fp, Gll^Fp
Gs^Fms, Gg, Gg, Re, Re, Gg, Gg^Vhc, Gg, Re, Ce, Ce, Gg, Gg, Re, Re, Gg^Eff, Gg^Eff, Gs^Fds, Gg, Gg, Gg^Efm, Gg, Gs^Vh, Gg^Efm, Gg^Efm, Gg, Re, Re, Re, Re, Gg, Gg, Gll^Fp, Gll^Fp, Gll^Fp, Gll^Fp, Gll^Fp, Gll^Fp, Gll^Fp, Gll^Fp, Gll^Fp, Gll^Fp
Gs^Fms, Gg, Ww^Ewf, Gg^Fet, Ww, Re, Re^Es, Re, Gg, Gg, Gg, Ch, Gg, Gg, Re, Re, Re, Gg, Re, Re, Re, Re^Efm, Re, Re, Re, Re, Re, Re, Gg, Re, Re, Gll^Fp, Gll^Fp, Gll^Fp, Gll^Fp, Gll^Fp, Gll^Fp, Gll^Fp, Gll^Fp, Gll^Fp, Gll^Fp, Gll^Fp
Gs^Fds, Gg, Ww, Ww, Gg, Gg, Re, Gg^Efm, Gg, Gg^Vh, Gg, Gg, Re, Re, Gg, Gg, Gg, Re, Gg, Gg, Gg, Re, Re^Es, Re, Re^Eff, Re^Eff, Re^Eff, Gg, Gs^Vh, Gg, Re, Gll^Fp, Gll^Fp, Gll^Fp, Gll^Fp, Gll^Fp, Gll^Fp, Gll^Fp, Gll^Fp, Gll^Fp, Gll^Fp, Gll^Fp
Gg, Gg^Wm, Re, Gg, Gs^Ecf, Ch, Ch, Re, Re, Re, Re, Re, Ch, Gg, Gs^Fds, Ce, Gs^Fds, Gs^Fds, Gg, Gg^Vwm, Gg, Re^Eff, Re^Gvs, Re, Re^Gvs, Gg^Gvs, Gg^Gvs, Gg^Eff, Re^Eff, Gs, Gll^Fp, Re, Re, Gll^Fp, Re, Gll^Fp, Re, Gll^Fp, Gll^Fp, Gll^Fp, Gll^Fp, Gll^Fp
Gg, Re^Gvs, Re^Gvs, Gg, Re, 3 Ket, Ch, Gg, Re, Gg, Gg^Vhc, Gg, Ce, Gg, Gs^Fds, Gs^Fds, Gs^Fds, Gg, Re^Eff, Gg, Rb^Gvs, Re^Gvs, Rb^Gvs, Rb^Gvs, Rb^Gvs, Re^Gvs, Re^Gvs, Re^Gvs, Re^Gvs, Gg, Gll^Fp, Gll^Fp, Gll^Fp, Re, Gll^Fp, Re, Gll^Fp, Re, Re, Gll^Fp, Gll^Fp, Gll^Fp
Re^Gvs, Re^Gvs, Re^Gvs, Re, Gg, Gs, Gg, Gg, Gs, Re, Re, Gg, Ce, Gg, Gg, Gs^Fds, Gg^Eff, Re^Eff, Re^Gvs, Rb^Gvs, Rb^Gvs, Rb^Gvs, Rb^Gvs, Rb^Gvs, Rb^Gvs, Rb^Gvs, Rb^Gvs, Re^Gvs, Re^Gvs, Gg, Gg^Eff, Gll^Fp, Gll^Fp, Gll^Fp, Gll^Fp, Gll^Fp, Gll^Fp, Gll^Fp, Re, Gll^Fp, Gll^Fp, Gll^Fp
Re^Gvs, Re^Gvs, Re^Gvs, Re^Gvs, Gs^Fds, Gg, Gs^Fds, Gg, Gs^Fds, Gs, Re, Gg, Gg, Gs^Fds, Gg, Gg, Gg, Gg^Gvs, Re^Gvs, Rb^Gvs, Rb^Gvs, Rb^Gvs, Rb^Gvs, Rb^Gvs, Re^Gvs, Re^Gvs, Re^Gvs, Re^Gvs, Re^Gvs, Re^Gvs, Re, Re^Eff, Re^Eff, Gll^Fp, Gll^Fp, Gll^Fp, Gll^Fp, Gll^Fp, Gll^Fp, Re, Re, Gll^Fp
Gg, Gg, Gg, Gg, Gs^Fds, Gs^Fds, Gs^Fds, Gs^Fds, Gs^Fds, Gs^Fds, Gs^Fds, Gs, Gg, Gs^Fds, Gg, Gg, Gg, Re^Gvs, Re^Gvs, Re^Gvs, Re^Gvs, Rb^Gvs, Re^Gvs, Re^Gvs, Re^Gvs, Re^Gvs, Re^Gvs, Re^Gvs, Re^Gvs, Re^Gvs, Re, Re^Eff, Gll^Fp, Gll^Fp, Gll^Fp, Gll^Fp, Gll^Fp, Gll^Fp, Gll^Fp, Gll^Fp, Gll^Fp, Re
