Mm, Mm, Mm, Wwg, Wwg, Wwg, Wo^Bw/, Wo, Wo, Wo, Wo, Wo, Wo, Wo, Wo, Wo, Wo, Wo, Wo, Wo, Wo, Wo, Wo
Mm, Mm, Mm, Mm, Re, Re, Gs^Fms, Wo, Wo, Wo, Wo, Wo, Wo, Wo, Wo, Wo, Wo, Wo, Wo, Wo, Wo, Wo, Wo
Mm, Mm, Hh, Gg, Re^Gvs, Gs^Wm, Gs, Wo, Wwg, Wo, Wwg, Wwg, Gg, Wo, Re, Wo, Wo, Wo, Wo, Wo, Wo, Wo, Wo
Hh, Hh, Gs^Fds, Gg, Re^Gvs, Re^Gvs, Gg, Gg, Wwg, Wwg, Wwg, Gg^Wm, Gg^Gvs, Gll^Feth, Re^Vh, Re^Es, Gg, Wo, Wo, Wo, Wwg, Wo, Wo
Hh, Gg, Gg, Re^Gvs, Re^Gvs, Re^Gvs, Cer, Gg, Gg, Wwg, Gg, Wwg, Gg^Gvs, Re^Gvs, Re, Gg^Es, Wwg, Wwg, Wwg, Wwg, Wwg, Wwg, Wwg
Hh, Hh, Gg^Vh, Re^Es, Gs, Gs, Gg, Ce, Re, Gg, Gg, Gg, Gg^Efm, Re, Gg, Gg, Gs^Fds, Gg, Gg, Wwg, Gg, Wwg, Gg
Gs^Fms, Gg, Gg, Re, Re, Gg, Gg^Vhc, Gg, Re, Cer, Ce, Gg, Gg, Re, Re, Gg^Eff, Gg^Eff, Gs^Fds, Gg, Gg, Gg^Efm, Gg, Gs^Vh
Gs^Fms, Gg, Ww^Ewf, Gd^Fetd, Ww, Re, Re^Es, Re, Gg, Gg, Gg, Rb^Dr, Gg, Gg, Re, Re, Re, Gg, Re, Re, Re, Re^Efm, Re
Gs^Fds, Gg, Ww, Ww, 1 Gg, Gg, 2 Re, Gg^Efm, Gg, Gg^Vh, Gg, Gg, Re, Re, Gg, Gg, Gg, Re, Gg, Gg, Gg, Re, Re^Es
Gg, Gg^Wm, Re, Gg, Gs^Edt, Chr, Chr, Re, Re, Re, Re, Re, Chr, Gg, Gs^Fds, Cer, Gs^Fds, Gs^Fds, Gg, Gg, Gg, Re^Eff, Re^Gvs
Gg, Re^Gvs, Re^Gvs, Gg, Re, 3 Ket, Chr, Gg, Re, Gg, Gg^Vhc, Gg, Gg^Dr, Gg, Gs^Fds, Gs^Fds, Gs^Fds, Gg, Re^Eff, Gg, Rb^Gvs, Re^Gvs, Rb^Gvs
Re^Gvs, Re^Gvs, Re^Gvs, Re, Gg, Gs, Gg, Gg, Gs, Re, Re, Gg, Cer, Gg, Gg, Gs^Fds, Gg^Eff, Re^Eff, Re^Gvs, Rb^Gvs, Rb^Gvs, Rb^Gvs, Rb^Gvs
Re^Gvs, Re^Gvs, Re^Gvs, Re^Gvs, Gs^Fds, Gg, Gs^Fds, Gg, Gs^Fds, Gs, Re, Gg, Gg, Gs^Fds, Gg, Gg, Gg, Gg^Gvs, Re^Gvs, Rb^Gvs, Rb^Gvs, Rb^Gvs, Rb^Gvs
Gg, Gg, Gg, Gg, Gs^Fds, Gs^Fds, Gs^Fds, Gs^Fds, Gs^Fds, Gs^Fds, Gs^Fds, Gs, Gg, Gs^Fds, Gg, Gg, Gg, Re^Gvs, Re^Gvs, Re^Gvs, Re^Gvs, Rb^Gvs, Re^Gvs
