Hh, Hh, Gs^Fds, Gg, Re^Gvs, Re^Gvs, Gg, Gg, Wwg, Wwg, Wwg, Gg^Wm, Gg^Gvs, Gll^Feth, Re^Vh
Hh, Gg, Gg, Re^Gvs, Re^Gvs, Re^Gvs, Cer, Gg, Gg, Wwg, Gg, Wwg, Gg^Gvs, Re^Gvs, Re
Hh, Hh, Re^Dr, Re^Es, Gs, Gs, Gg, Ce, Re, Gg, Gg, Gg, Gg^Efm, Re, Gg
Gs^Fms, Gg, Gg, Re, Re, Gg, Re^Dr, Gg, Re, Cer, Ce, Gg, Gg, Re, Re
Gs^Fms, Gg, Ww^Ewf, Gd^Fetd, Ww, Re, Re^Es, Re, Gg, Gg, Gg, Rb^Dr, Gg, Gg, Re
Gs^Fds, Gg, Ww, Ww, Gg, Gg, Re, Gg^Efm, Gg, Re^Dr, Gg, Gg, Re, Re, Gg
Gg, Re, Re, Gg, Gs^Edt, 1 Ke, Chr, Re, Re, Re, Re, Re, Chr, Gg, Gs^Fds
Gg, Re^Gvs, Re^Gvs, Gg, Re, Cer, 2 Ke, Gg, Re, Gg, Re^Dr, Gg, Gg^Dr, Gg, Gs^Fds
Re^Gvs, Re^Gvs, Re^Gvs, 3 Re, Gg, Gs, Gg, Gg, Gs, Re, Re, Gg, Cer, Gg, Gg
Re^Gvs, Re^Gvs, Re^Gvs, Re^Gvs, Gs^Fds, Gg, Gs^Fds, Gg, Gs^Fds, Gs, Re, Gg, Gg, Gs^Fds, Gg
Gg, Gg, Gg, Gg, Gs^Fds, Gs^Fds, Gs^Fds, Gs^Fds, Gs^Fds, Gs^Fds, Gs^Fds, Gs, Gg, Gs^Fds, Gg
